1111111111
1P00E00C01
10C00C1001
1111111111
1000000001
1000001001
1000000001
1000000001
1000000001
1111111111
