1111111111
1P00CC0CE1
1111111111