1111111111
1P00EC0C01
10C00C1001
1110X11111
1000000001
11C0111C01
100C00X0C1
1111111111
